Agri Decumates = Агры Дэкуматэс
Alans = Аланы Аланскі
Alemans = Алеманы Алеманскі
Alps = Альпы
Angles = Англы Англійскі
Anteans = Анты Анцкі
Argyll = Аргайл
Arian = Арыянства Арыянскі
Arianism = Арыянства
Armenia = Арменія
Asdingi = Асьдзінгі
Bactrian = Бактрыя Бактрыйскі
Baiohaemum = Баёхаэмум (Багемія)
Bosporan = Боспар Баспорскі Баспорцы
Britannia = Брытанія Брытанскі
Bructeri = Бруктэры
Burgundians = Бургунды Бургундзкі
Caledonians = Калядонія Калядонскі Калядонцы
Carpathian = Карпацкім
Caspian Sea = Касьпійскае Мора
Chamavi = Хамавы Хамаўскі
Chauci = Хаўкі Хаўскі
Constantinople = Канстанцінопаль Канстанцінопальскія
Danubian = Дунай Дунайскія
Dniester = Днестр Днястра
Don = Дон 
Elbe = Эльба
Etruscan = Этрускі 
Eurasian = Еўразія Еўразійскі
Frankish = Франкі Францкі
Frisian = Фрызы Фрызкі
Gaelic = Гэлы Гэльскія
Gallia = Гальлія
Gaul = Галія
Gepids = Гепіды Гепідзкі
Germania = Германія
Goths = Готы Гоцкі
Great Barbarian Conspiracy = Вялікай Барбарскай Змовы
Greuthungians = Грэўтунгі Грэўтунскі
Hebrides = Гебрыд Гебрыдзкі Гебрыды
Hellenistic = Эліністычны
Heruls = Герулы
Huns = Гуны Гунскі
Illyricum = Ільлірыкум
Indo-Iranian = Індаіранскі
Isaurians = Ісаўрыя Ісаўрыйскі Ісаўрыі
Italia = Італія
Jazyges = Языгі Языскі
Jutes = Юты Юцкі
Jutland = Ютландыя
Kazakh = Казаскі
Langobards = Лангабарды Лангабардзкі
Lugii = Лугі
Marcomans = Маркоманы Маркоманскі
Maskuts = Маскуты Маскуцкі
Massagetae = Масагеты
Neckar = Некар
Ostrogoths = Остраготы Острагоцкі
Pannonia = Панонія
Picts = Пікты Пікцкі
Pontic = Понт Пантыйскі
Quadians = Квады Квадзкі
Rhine = Рэйн
Roman = Рым Рымскі Рымляне
Sarmatian = Сарматы Сармацкі
Sasanians = Сасаніды Сасанідзкі
Saxons = Саксы Саксонскі
Scandinavia = Скандынавія
Scirians = Скіры Скірскі
Sclavenians = Склавены Склавенскі
Scots = Шатландыя Шатландзкі Шатландцы 
Sicily = Сіцылія
Silingi = Сілінгі
slavic = Славяне Славянскі
Sogdians = Сагдыя Сагдыянскі Сагдыяны
Suebians = Сьвебы Сьвебскі
Thervingians = Тэрвінгі Тэрвінскі
Ulster = Ульстэр Ульстэрскі Ульстэры
Vandals = Вандалы Вандальскі
Venedians = Венеды Венедзкі
Venetia = Венецыя
Vesians = Весы Вескі
Visigoths = Вісіготы Вісігоцкі
Vistula = Вісла
Volga = Волга
Xiongnu = Хунну