Balion = Баліён, Баліёнскі, Баліёны
Balionling = Баліёнлінг Баліёнлінскі Баліёнлінгі
Battaneid = Баттанэя, Баттанэcкі
Biscanjan = Бісканжан, Бісканжанскі
Bragantjan = Брагантжа, Брагантжанцкі, Брагантжаны
Calradicós = Кальрадыкоскі
Calradoi = Кальрадыя, Кальрадыйскі, Кальрадыйцы
Darshi = Даршы, Даршыйскі
Devseg = Дэўсагі, Дэўсаскі
Devseglar = Дэўсаглар, Дэўсагларскі, Дэўсаглары
Dryaticoi = Драятыка, Драятычны, Драятыкі
Eleftheroi = Элефтэрой, Элефтэройскі
Ember = Вугаль
Furqanan = Фурканан, Фуркананскі
Geroia = Героя, Героясы
Geroiako = Герояскі
Ghilman = Гільманы, Гільманскі
Haimolainen = Гаймолайнскі
Iltanlar = Ільтанлар, Ільтанларскі, Ільтанлары
Jarjarawi = Джарджараві, Джарджараўскі
Jawwal = Джаввал, Джаввальскі, Джаввалы
Jumne = Юмнэ, Юмнэскі
Kannic = Каньніка, Каньнійскі, Каньнійцы
Laconian = Лаконія, Лаканійскі, Лаканійцы
Lakonikós = Лаконікоскі
Lokti = Локці, Лоскі
Loktiu = Локці, Лоскі
Massa = Масса, Масскі, Массы
Nahasawi = Нахасаўі, Нахасаўскі
Osrickin = Оcрыкін, Оcрыкінскі, Оcрыкіны
Palaicoi = Палая, Палайскі
Qarawulnud = Каравульнускі
Qesher = Кешэрскі
Rhodok = Родак, Родаскі, Родакі
Sarrani = Сарранскі
Serattigu = Серацьцігускі
Siri = Сіры, Сірыйскі, Сірыйцы
Sturgiske = Стургія, Стургійскі
Swadian = Свадзія, Свадзійскі, Свадзійцы
Tyalese = Цялія, Цялійскі
Vaegir = Вагір, Вагірскі
Vakken = Ваккен, Ваккенскі
Vanni = Ваньні, Ваньнійскі
Vriman = Врыманскі
Widugauja = Ўідугаўя, Ўідугаўскі
Wilunding = Ўілунд, Ўілундзкі, Ўілунды
Zendari = Зэндар, Зэндарскі