Black Ship = Чорны Карабель
blizzard = Завея
Boarding = абардаж
boat = карабель
Buddhists = Будысты (рэлігія)
camp = лагер
Cannon = гармата
capacity = грузападымальнасьць (грузы) ёмістасьць (ваяры)
Crude Currency = Грубы Валютны Абарот
enlisted = найміт найманьня найміцтва
Farm = фальварак
lord = гаспадар у сэнсе караля
messenger = вястун
Onin = Онін
Port = Порт
Portuguese = Партугалія Партугальскі
promoted = прасунуць (кампаньёна)
ramie = рамі рамівы
Rinzai = Рындзай (рэлігія)
Ryogoku = Рагоку
Sengoku Jidai = Сэнгоку-Дзідай
Shin = Сін (рэлігія)
Shingon = Сінгон (рэлігія)
Shinto = Сінто (рэлігія)
Shintoists = Сінтоісты (рэлігія)
ship = карабель
Shogunate = Сёгунат
Shokuho = Сёкухо
shrine = сьвяцілішча
Single-Minded Devotion = Мэтанакіраванай Адданасьці
Soto = Сато (рэлігія)
task = заданьне
Temple = храм
Tendai = Тэндай (рэлігія)
Triple Alliance = Траісты Хаўрус
Tumed = Тумедзкі
vessel = судна (вялікае не манеўранае, звычайна транспартнае)