Baltic = Балтыя, Балтыйскі, Балты
Bartians = Барты Бартыйскі
belief = вераваньні
Beloozero = Белавозера Белаазёрскі
Bohemian = Багемія Багемскі
Danish = Данія, Дацкі
Devotion = шанаваньне
Dregovichi = Дрыгавіцкі
Estonian = Эсты, Эстонскі, Эсцкі
Father = айцец ойча (сьвятар)
German = Германскі
Krivichi = Крывіцкі
Kuyavia = Куявія Куяўскі
Masovia = Мазавія Мазавецкі
Military Service = Вайсковая Служба
Mongol = Манголы Мангольскі
Nadruvians = Надрува Надрувы
Natangians = Натангі Натанскі
Northern Crusaders = Паўночныя Крыжакі, Паўночнакрыжацкі
Oeselian = Осэльскі
old believers = стараверы
Pogesanians = Погезаны Погезанскі
Polish = Польшча Польскі
Pomerania = Померанія Померанскі
Pomerelia = Померэлія Померэльскі
Pomesanians = Помезаны
Preacher = Прапаведнік
priest = сьвятар
Prussian = Прусія, Прускі
Rostov = Растоў Растоўскі
Rus = Русь, Руські, Русіны
Sambians = Самбы
Stash = Склад
Teutonic = Тэўтонскі, Тэўтоны
Toropets = Таропец Таропецкі
Turov-Pinsk = Тураў-Пінск Турава-Пінскі
Tver = Цьвер Цьвярскі
Warmians = Вармы
Yaroslavl = Ярославль Ярославльскі