Anduin = Андуін
Aran = Аран
Bard the Bowman = Бард Лучнік
Bardings = Бардынгі
Dale = Дэйл Дэйлскі
Dark Lord Sauron = Цёмны Уладар Саўран
Dunland = Дунланд Дунландзкі Дунланды
East = Усход
Easterlings = Усходлінгі
Eldar = Эльдар
Elven Rings = Эльфійскіх Пярсьцёнкаў
Erebor = Эрэбор Эрэборскі
Free Peoples = Вольныя Народы
Golden Realm of Rhûn = Рунскае Залатое Панства
Golden Wood = Залаты Лес
Gondor = Гондар Гондарскі Гондары
Great Desert of Haradwaith = Вялікая Пустэльня Харадвайт
Harad = Харад Харадзкі
Harwan = Харван Харванскі
Imladris = Імладрыс Імладрыскі
Khand = Кханд Кхандзкі
Khûdriag = Кхудрыяг
King of the Mark = Кароль Маркі
Lasgalen = Ласгален Ласгаленскі
Lonely Mountain = Самотная гара
Lothlórien = Латлорыен Латлорыенскі
Mallorn = Маллорн Маллорнскі
Middle-earth = Міжзем'е Міжземскі
Mirkwood = Мірквуд Мірквудзкі
Misty Mountains = Імглістыя горы
Mordor = Мордар Мордарскі
Númenor = Нуменор Нуменорскі Нуменоры
Refuged of Imladris = Імладрыскі Прыстанак
Rhûn = Рун Рунскі
Riddermark = Рыддэрмарка (Рохан)
Rings = Пярсьцёнкі
Rohan = Рохан Роханскі
Rohirrim = Рохіррым Рохіррымскі Рохіррымы
Sauron = Саўран
Silvan Elves = Сільванскія Эльфы
Smaug = Смаўг
Taskral = Таскрал
Taskralan of Harwan = Харванскае Таскралства
Variags = Варыягі 
White Mountains = Белыя Горы
Windrider = Наезьнік Ветру