A'dam = а'дам
Aes Sedai = Аэс Седай (жанчына)
Age of Legends = Эра Легендаў
Aiel = Аель, Аельскі, Аелы
Aiel War = Аельская Вайна
Aiel Waste = Аельскай Пустэчы
Ajah = Ажах
Alguenya = Альгунія
Altara = Альтара, Альтарскі, Альтары
Amadicia = Амадзікія, Амадзіскі, Амадзійцы
Amamdicia = Амадзікія, Амадзіскі, Амадзійцы
ammo = зарад у дачыненьні магіі
Amyrlin Seat = Стол Амірліна
Andor = Андор, Андорскі, Андоры
Arad Doman = Арад Доман, Арадоманскі, Арадоманы
Arafel = Арафэль, Арафэльскі, Арафэлы
Aringill = Арынгілл
Artur Hawkwing = Артур Хаўквінг
Aryth Ocean = Арыцкі Акіян
Asha'man = Аша'ман
Avendesora = Авендэсора
Avendoraldera = Авендоралдэра
Banikhan range = Баніханскі Хрыбет
Black Tower = Чорная Вежа, Чорнавежавы
Black Tower = Чорная Вежа, Чорнавескі
Blood = Кроў Крывя
Bloodborn = Крэўнанароджаны
Borderlander Kingdoms = Каралеўствы Памежжа
Borderlands = Памежныя Землі, Памежжа
Breaking of the World = Раскол Сьвету
Brothers of the Eagle = Арліныя Браты
Cairhien = Кайрыен, Кайрыенскі, Кайрыены
chaneller = Канальлер
channeling = Канальлер
Children of the Light = Дзеці Сьвятла
Children of the Light = Дзяцей Сьвятла
Cindaking = Сіндакінг
Council of Merchants = Сойм Гандляроў
Creator = Стваральнік
Crown High Council = Вышэйшы Каралеўскі Сойм
Damane = даман (сянханская жанчына-канальлер)
Dark One = Цёмны
Darkfriends = Цёмныя Сябры
Darkfriends = Цёмныя Сябры
Dedicated = Пасьвячоны (ранг)
Dhagon = Дагон (рака)
Dragon = Цмок
Dragon Reborn = Цмачыны Перароджаны
Dragonsworn = Цмачыны Зарочаны
Dragonsworn = Цмачыныя Зарочаныя
Eldar = Эльдар (рака)
Erinin = Эрынін
Eyeless = Бязвокі
False Dragons = Несапраўдня Цмокі
Far Dareis Mai = Фар Дарэйс Май
Far Madding = Фар Мадзьдзінг, Фармадзьдзінскі
Forsaken = Пакінуты
Fort = Фартэца
Fortress = Фартэцыя
Ghealdan = Геальдан, Геальданскі, Геальданы
Grand Alliance = Вялікі Хаўрус
Great Blight = Вялікі Заняпад
Great Hunt = Вялікае Паляваньне
Hunters for the Horn = Паляўнічыя Рогу
Illian = Ільліан, Ільліанскі, Ільліаны
Illuminator = Ілюмінатар
Jangai Pass = жангайскі Перавал
Kandor = Кандор, Кандорскі, Кандоры
Kinslayer's Dagger = Кінжал Забойцы Каралёў
Leash Holder = Трымальнік Ланцуга (сул'дам)
Luthair = Лутайр
Maidens of the Spear = Паны Кап'я
Malkier = Малкіэр, Малкіэрскі, Малкіэры
Manetherendrelle = Манетэрэндрэль
Maraside Mountains = Марасідзкія Горы
Maredo = Марэдзкіх Раўнінах
Mayene = Маен, Маенскі, Маены
Mazrim Taim = Мазрым Тайм
Mountain Dancers = Горныя Танцоры
Mountains of Mist = Імглістыя Горы
Murandy = Мурандзі, Мурандзкі, Мурандзійцы
NE = НЭ
Old Tongue = старажытная мова
One Power = Адзіная Моц
Pattern = Патэрн
Pattern of the Ages = Патэрн Эраў
Plain of Lances = Капійная Раўніна
Rand al'Thor = Ранд аль'Тор
Randland = Рэндлянд
Return = Вяртаньне
Return = Вяртаньне (Сянхан)
saidar = сайдар
saidin = сайдзін
Saldea = Сальдэя, Сальдэйскі, Сальдэі
Sea Folk = Марскі Народ
Sea of Storms = Штармавое Мора
Seanchan = Сянхан, Сянханскі, Сянханы
Servants of All = Слугі Ўсіх
Shadow Coast = Узьбярэжжа Ценяў
Shadowspawn = Ценявое Параджэньне
Shai'tan = Шай'тан
Shara = Шара, Шарскі
Sharia = Шарыя (рака)
Shienar = Шынар, Шынарскі, Шынары
Silk Path = Шаўковы Шлях
Spine of the World = Хрыбет Сьвету
Stone = Камень Камяні
Stone Dogs = Каменныя Сабакі
Stone of Tear = Каменныя Сьлёзы
sul'dam = сул'дам (Трымальнік Ланцугу)
Tairen = Тайрэн
Tarabon = Тарабон, Тарабонскі, Тарабоны
Tear = Цір, Цірская, Ціры
Throne of the Winds = Трон Вятроў
Thunder Walkers = Штармавыя Хадакі
Toman Head = Галава Томана
Trolloc = Троллак, Тролласкі
Trolloc Wars = Тролласкія Войны
True Source = Праўдзівая Крыніца
Voice = Голас
Watchers Over the Waves = Назіральнікі над Хвалямі
Westlands = Заходнія Землі
Wheel = Кола
Wheel of Time = Кола Часу
White Tower = Белая Вежа, Белавескі, Белавежы
Whitecloak = Белыя Покрывы
World's End = Канец Сьвету