Aeril = Эрыл
Agalea = Агалея
AI = (штучны інтэлект) ШІ
alley = завулак
alliance = хаўрус
ammo = снарадаў
aquaduct = акведук
Arenicos = Арэнікос
Arkits = Аркіт, аркіцкі, аркіты
artisan = рамесьнік
Aserai = Асэрай, асэрайскі, асэраі
attached ship = карабель, якім вы кіруеце (у кантэксьце навыкаў)
attribute = атрыбут
badge = адзнака
Bannerlord = Сцяганосцам
Bash = стукнуць
Battania = Баттанія, баттанійскі, баттанійцы
behavior = паводзіны
Below = Падзем'е
blockade = блакада
blunt = абуховая
boosting = Фарсаваньне
braced polearm = наезд дзіды
Byalic = Баялік
Calculating = Разважлівасьць
Calradia = Кальрадыя, кальрадыйскі, кальрадыйцы
Calradios = Кальрадыёс
Captain (multiplayer) = Капітаны
Caution, Cautious = Баязьлівасьць
cavalry = коньніца
character = персанажа
charcoal = дрэвавага вугалю
charge = напор
charging = атакаваць
cheat = Чыт
cheer = радавацца
cohesion = згуртаванасьць
commendations = падхяка
conformity = згода
consider = Абмеркаваць
contact = кантакт
contract = Дамова
control = кіраваньнe
couch Lance = Наезд дзідай
couchable = Наезд дзідай
council = рада
courtship = Заляцаньне
courtyard = дзядзінец
CPU = працэсар
Criminal Rating = крымінальны рэйтынг
Cruelty = Жорсткасьць
Custom = уласны
cutting = рэжучых
Daily defaults = штодзённыя справы
dealt = прычынянай шкоды
decisions = пастановы
default = прадвызнач. прадвызначанае стандартнае па стандарту
denars = дэнары
devastate settlement = спустошыць селішча
Deviousness = Крывадушша
Disloyalty = Скупасьць
dungeon = вязьніца
EA (early access) = РД (раннім доступе)
Emotional = Эмацыйнасьць
encounter = сутыкненьне
encumbrance = Абцяжарваньне
endurance (END) = трываласьць (ТРЫ), Intelligence (INT) = Інтэлект (ІНТ), Кантроль (КАН) = control (CTR), Cunning (CNG) = Хітрасьць (ХІТ), Social (SOC) = Сацыяльнасьць (САЦ), Vigor (VIG) = дужасьць (ДУЖ)
enterprises = прадпрыемстваў
etc. = (і гэтак далей) і г.д.
farm = Гаспадарка
farmer = земляроб
Fencing = Пакрывальніцтва
fief = воласьць воласьці воласьцю воласьцяў валасьцямі
flagship = флагман
focus points = ачкі фокуса
foot = пры бітве пешым
forfeit = Штраф
formation = пабудова
friendly = сяброўская (шкода)
gambling dens = гульнявых прытонаў
Game Host = Майстар Гульняў
gang leader = верхавод банды
Generosity = Шчодрасьць 
gentle blood = блакітная кроў
Geroia = Джэроя
goods = тавары
governed = кіраваны
governed settlement = кіраваным селішчы
Governor = староста старосту старосьце старостам
GPU = відэакарты
Hageos Tristamos = Хагеос Трыстамос
handling = кіруемасьць
hardwood = драўніны
harness = вупраж
hearth = дым (старажытная назва)
hideout = Сховішча
hit Points = ачкі ўдару, ачкоў ўдару 
honor = Гонар
Honor = Сумленнасьць
household = дом ці гаспадарку (ад кантэксту)
hp = аў
i.e. = то бок т.б.
incursions = набегі
insulted = абразіў
Issues = Праблемы
item = прадмет
jewelery = каштоўнасьцяў
Kannic = Каньнійскі
Karakhergits = Карахергіты, карахергіцкі, карахергіты
keep = вязьніца
keep = Замак
Khergits = Хергіты, хергіцкі, хергіты
Kheshig = Хэшыг
Khuzait = Хузаіт, хузаіцкі, хузаіты
kick = штурхнуць
kick = штуршок, штурхаля
kiln = печ
kingdom = гаспадарства (гістарычная назва)
Knock Off = Адкідваньне
knockback resistance = супраціву збіваньню
knockdown = накдаўн
knocked unconscious = зьнепрытомеў прытомнасьць
Laconian = Лаконія, Лаканійскі, Лаканійцы
lady = пані паненка 
lady = Шляхцянка шляхцянцы
ladyship = шляхетнасьць
lance = дзіда
levy = рушэньне
liege = гаспадар гаспадарыня шляхціч шляхцянка (у залежнасьці ад кантэксту)
line, Loose, Circle or Scatter = Лінія, Россып, Кольца ці Роскід
lord = пан пане
lord = Шляхціч
lord's hall = зала шляхты
lordship = шляхетнасьць
madam = пані
madame = пані
Marcorionist = Маркорыяніст
marketplace = Кірмаш
matchmaking = стварэньня матча
mercenaries = наймітаў
Mercy = Літасьць
milady = пані
militia = Рушэньне
mount = Конь
mounted = конны, вярхом на кані
murder hole = адтуліны для забойстваў
mute = Заглушыць
MVP = Самы каштоўны гулец = СКГ
my lady = пані 
N/A = НП
Nachaghan = Начагэн
Nahasa = Нахаса
Neretz = Нэрэц
Neretzes' Folly = Дурасьць Нэрэца
noble = шляхціч шляхце
Nordlands = Нордланд
Nordvyg = Нордвіг Нордвіскі
notable = зямяне зямянін зямянінам зямянаў
noyans = ноян
npc = НГП
of the Chosen = з Абраных
of the Covenant = з Запавету
of the Hills = з Узгоркаў
of the Keepers = з Захоўнікаў
of the Lakepike = з Азёрных шчупакоў
of the Wastes = з Адкідаў
oil = алей
order = замова (квэст)
outputs = Прыбыткі
owner = уласьнік (асн.), спадар
pack animals = уючных
Palaic = Палая, палайскіх, палайцы
parley = перамовы
party = партыя
Pendraic = Пендрак
Perassic Sea = Перасічнае мора
perk = перавага
persuade = пераканаць
piercing = колючых
Point = ачко
polearm = дзіда (калі зброя) тронкавай зброі (калі навык)
policy = палітыкі
poll = апытаньне
pottery = ганчарных вырабаў
practice mp = трэніроўка
premade = Ствараемай
prosperity = Росквіт
raid = рабаваць калі дзеяньне або рабаваньне вёскі
ram = Тараны
randomize = выпадкаваць
rank = Рангавы Ранг
rebels = Паўстанцы
refine = паляпшэньне
relation = адносіны
renown = вядомасьць
report = скаргі
resolution = Разрознасьць
respawn = адраджэньне
rogue = нягоднік
ruler = гаспадар (старажытная назва)
sail force = сіла ветразя
sallying out = выбег
sallying out = вылазца
scoreboard = дошку вынікаў
seaworthy ships = марскія караблі
security = бясьпека
shared experience = агульнага досьведу
shared wars = сумесныя войны
sigil = герб
sir = пан пане
skill = навык
skirmish (multiplayer) = Сутычка Сутычцы
skirmish = Сутычка (конь)
skirmishing = перастрэльваюцца
slots = вочка вочак
smelt = плаўка плаўленьне
smithy Stamina = Стомленасьць каваля
Sneak = утойлівы
sold = Сбыты
SP = (адзінкавая гульня) АГ
spawn = адраджэньне
spear = кап'ё
spy = шпег
steward = загадваньне загаднік
stock = запас
Sturgia = Стургія, стургійскі, стургійцы
supplies = запасы
swing = Рэжучы 
swing Speed = рэжучай хуткасьці
tab = закладца
tariff = мыта
Taunt = Зьдзек
taxes = падаткі
tenants = наёмныя працоўныя
throwing weapons = кідальная зброя
thrown weapons = кідальнай зброяй
thrust Damage = колючая шкода, хуткасьць уколу
thugs = бандыты
tier = Узровень
Trade Agreement = гандлёвая дамова
traits = асаблівасьці
tribute = даніна
troop = ваяр
tutorials = падказкі
UI = КІ
upgrade = Паляпшэньні
Urkhun the Great = Урхун Вялікі
Vaegir = Вагіраў
Vakken = ваккен, ваккенскі, ваккены
Valor = Адвага
village = вёска
VIP (Very important person) = ВВП (Вельмі важная персона)
Vlandia = Вландыя, вландыйскі, вландыйцы
wage = выдаткі
warehouse = склад
Warmup = Разагрэў
weak = нядужы
wealth = багацьця
workshop = майстэрня
worth = вартасьць
wounded = ранены
xp = досьвед
yield = прыбытак
young adulthood = Маладосьць
