Andalusian = Андалузкі
Anglo Saxon = Англа-Саксонскі
Ayyubid = Аюбідзкі
Bayeux = Баюскі
Bolzano = Больцанскі
Byzantine = Бізантыйскі
Chi Roh = Хрызма, Хрызматычны
Coppergate = Коппергэйцкі
Crusader = Крыжацкі
Dargen = Даргенскі
English = Англійскі
German = Германскі
Gjermundbu = Гьярмундбюскі
Iberian = Іберыйскі
Kairouan = Кайруанскі
Kodasoo = Кодаскі
Konstanz = Констанскі
Legnago = Леньягоскі
Maciejowski = Мацеёўскі
Marsleben = Марсьлібэнскі
Mena = Менаскі
NICHE = Ніскі
Norman = Нарманскі
Phrygian = Фрыгійскі
Rus = Руські
Sally Out = Выбег
Samlinger = Самлінгерскі
Seljuk = Сэльджускі
Spanish = Гішпанскі
Svenel = Сьвенэльскі
Vestfold = Вэстфальскі
Vilnius = Віленскі
Wilnsdorf = Вільнсдорфскі