Abbasid = Аббасідзкі, Аббасіды
Achaemenid = Ахамэнідзкі, Ахамэніды
Alan = Аланскі, Аланы
Almoravid = Альмаравіды, Альмаравідзкі
Amazigh = Амазігія, Амазіскі, Амазігі
Arab = Арабскі, Арабы
Aragonese = Арагон, Арагонскі, Арагоны
Armenian = Армянскі
Baltic = Балтыка, Балтыйскі, Балты
Berber = Берберскі, Берберы
Britannia = Брытанія, Брытанскі
Bulgarian = Балгарыя, Балгарскі, Балгары
Byzantine = Бізантыя, Бізантыйскі, Бізантыйцы
Castile = Кастылія, Кастыльскі, Кастыльцы
Crusader = Крыжакі, Крыжацкі
Cuman = Полаўцы, Палавецкі
Danish = Данія, Дацкі, Датчане
Denmark = Данія, Дацкі, Датчане
English = Англія, Англійскі, Англічане
Fatimid = Фаціміды, Фацімідзкі
France = Францыя, Францускі, Французы
Frankish = Францкі, Франкі
Friisian = Фрызійскі
Gaelic = Гэлы, Гэльскі
Gascons = Гасконія, Гасконскі, Гасконцы
Genoese = Генуя, Генуэскі
Georgians = Картвэлія, Картвэльскі, Картвэлы
German = Германія, Германскі, Германцы
Goidelic = Гоідэлы, Гоідэльскі
Hamamdid = Хаммадзіды, Хаммадзідскае
Hungarian = Вугорыя, Вугорскі, Вугорцы
Iberian = Іберыйскі
Imazighen = Амазігія, Амазіскі, Амазігі
Irish = Ірландыя, Ірландзкі, Ірландцы
Italian = Італія, Італьянскі, Італьянцы
Kipchaks = Кіпчакі, Кіпчаскі
Magyar = Мадзярскі, Мадзяры
Nordic = Нардычны, Норды
Norman = Нарманскі, Нарманы
Norse = Нарвегія, Нарвескі, Нарвежцы
Norway = Нарвегія, Нарвескі, Нарвежцы
Outremer = Утрумэр, Утрумэрскі, Утрумэры
Papal = Папства, Папскія, Папы
Pecheneg = Печанегі, Печанескі
Persian = Персія, Персіцкі, Персы
Pisans = Піза, Пізанскі, Пізанцы
Polish = Польшча, Польскі, Палякі
Portuguese = Партугалія, Партугальскі
Prussian = Прусія, Прускі, Прусы
Roman = Рым, Рымскі, Рымляне
Rum = Рум, Румскі, Румы
Rus = Русь, Руські, Русіны
Saracen = Сарацынскі, Сарацыны
Saxon = Саксонскі
Scottish = Шатландыя, Шатландзкі, Шатландцы
Seljuk = Сэльджукі, Сэльджускі
Serbian = Сербія, Сербскі, Сербы
Sicilian = Сіцылія, Сіцылійскі, Сіцылійцы
Spanish = Гішпанія, Гішпанскі, Гішпанцы
Sudanese = Судан, Суданскі, Суданскія
Sweden = Швецыя, Швецкі, Шведы
Taureg = Туарэг, Туарэскі
Turco = Цюркі, Цюрскі
Turkic = Цюркі, Цюрскі
Turkish = Турцыя, Турэцкі, Туркі
Varangian = Вараскі, Варагі
Venice = Венецыя, Венецыянскі
Wales = Ўэльс, Ўэльскі, Ўэльцы
Welsh = Ўэльс, Ўэльскі, Ўэльцы