Alan = Аланы, Аланскі
Albigensian = Альбігойскі
Alger = Алжыр, Алжырскі
Almogavar = Альмагавары, Альмагаварскі
Almogavar = Альмогавары, Альмогаварскі
Almohads = Альмохады, Альмохадзкі
Anatolian = Анаталійскі
Andalusian = Андалузкі
Anglo-Norman = Англа-Нарманская
Anglo-Saxon =  Англа-Саксонскія
Aragonese = Арагон, Арагонскі, Арагоны
Armenia = Арменія Армянскі Армяне
Asturia = Астурыя, Астурыйскі
Asturias = Астурыя, Астурыйскі
Ayyubid = Аюбіды, Аюбідзкі
Balkan = Балканскі
Baltic = Балтыя, Балтыйскі, Балты
Berber = Берберы, Берберская
Bohemia = Багемія, Багемскі, Багемцы
Bosnia = Босьнія Басьнійскі
British = Брытанія, Брытанскі
Brittany = Брэтань Брэтаньскі
Bulgarian = Балгарыя, Балгарскі
Byzantine = Бізантыя, Бізантыйскі
Cambro (Cambria) = Кабрыя, Камбрыйскі
Capet = Капеты
Carolingian = Каралінскі, Каралінгі
Castile = Кастылія, Кастыльскі, Кастыльцы
Catalan = Каталонія Каталонскі
Celtic = Кельты, Кельцкі
Cornwall = Корнўэлы, Корнўэльскі
Crusader = Крыжакі, Крыжацкі
Cuman = Полаўцы, Палавецкі
Denmark = Данія, Дацкі, Датчане
Egypt = Егіпет, Егіпецкі, Егіпцяне
English = Англія, Англійскі, Англічане
France = Францыя, Францускі, Французы
Frankish = Франкія, Францкі, Франкі
French = Францыя, Францускі, Французы
Gaelic = Гэльлія, Гэльскі, Гэлы
Galicia–Volhynia = Русь, Руськае
Genoa =  Генуя, Генуэскі
Genoese = Генуя, Генуэскі
Georgia = Сакартвэла Картвэльскі Картвэлы
German = Германія, Германскі, Германцы
Golden Horde = Залатая Арда
Granada = Гранада, Гранадзкі
Greek = Грэцкі
Guelph = Гўэльфы
Guisarmer = Гвізарма, Гвізармар
Hafsid = Хафсіды, Хафсідзкі
Halqa = Халканскі
halych = Галіцыя Галіцкі Галічане
Hohenstaufen = Гогенштаўфены
Holy Roman Empire = Сьвятая Рымская Імперыя
Hospitaller = Шпітальеры
Hülegü = Хулэг, Хулэскі
Hungarian = Вугорыя, Вугорскі, Вугорцы
Ibelin = Ібелінскі
Ilkhanate = Ілханат, Ілханацкі, Ілханаты
Italian = Італія, Італьянскі, Італьянцы
Khwarazmians = Харазмійцамі
Kievan = Кыіў, Кыіўскі
Kipchak = Кыпчакі
Kurdish = Курды, Курдзкі
Latin = Лацінскі
León = Леон, Леон
Mamluk = Мамлюкі, Мамлюскі
Marinid = Марыніды, Марынідзкі
Masovian = Мазавецкі
Massagetoi = Масагеты, Масагецкі
Mongolian = Манголы Мангольскі
Moorish = Маўры Маўрытанскі
Navarre = Навара Наварскі
Nicaea = Нікея, Нікейскі, Нікейцы
Nicene = Нікея, Нікейскі, Нікейцы
Norway = Нарвегія, Нарвескі, Нарвежцы
Outremer = Утрумэр, Утрумэрскі, Утрумэры
Papal = Папа, Папскі
Persian = Персія, Персіцкі, Персы
Polish = Польшча, Польскі, Палякі
Portugal = Партугалія, Партугальскі, Партугальцы
Roman = Рым, Рымская, Рымляне
Rus = Русь, Руські, Русіны
Sami = Саамы, Саамскі
Sámi = Саамы, Саамскі
Santiago = Сант’яга
Scandinavian = Скандынаўскі
Scottish = Шатландыя, Шатландзкі, Шатландцы
Seljuq = Сэльджукі, Сэльджускі
serbia = Сербія Сербскі
Sicily = Сіцылія, Сіцылійскі, Сіцылійцы
Slavonia = Славонія Славонскі
Spanish = Гішпанія, Гішпанскі
Sweden = Швецыя, Швецкі, Шведы
Teutonic = Тэўтоны, Тэўтонскі
Tlemcen = Тлэмсэн, Тлэмсэнскі
Turcopole = Туркапульскі
Turkic = Цюркі, Цюрскі
Ulug = Улуг, Улускі
Varrangoi = Вараг, Вараскі
Venice = Венецыя, Венецыянскі
Welsh = Ўэльс, Ўэльскі
Wessex = Ўэсэкс, Ўэсэцкі
Zayyanid = Заянід, Заянідзкі
Zenata = Зэнацкі