acreage = акры
acres = акры
Aspects = асьпекты
assimilation = асіміляцыі
attractiveness = прывабленьне, прывабнасьць
blessing = блаславеньне
Canticles = Песьнясьпевы
claim = прэтэнзіі
clergymen = сьвятарства
Code of Asera = Зборы Эсэра
Competence = Кампетэнцыя
contract = дамоўныя, дамова
council = Соймавы Соймавага Сойм 
Court = Палац
Courtiers = Палацавыя
Courting = заляцаньне
Darusosian = Дарускага, Дарусос
Demesne = удзел
Derwyddon = Дэрўіддон
divus = абагаўленьне
Doctrines = Дактрыны
Dowry = пасаг
duty = абавязак
Election = выбары
estate = маёнтак
exemptions = палёгкі
faiths = вера, вераньні
Farmlands = засевы
fascination = захапленьне
feast = фэст
Fertility = Урадлівасьць
Fervor = Палкасьць
festival = фэстываль
Flamines Castus = Полымянус Цнатлівум
fluency = валоданьне
foreigners = замежнікі
goliard = галіярд
government = урад
Governor = староста старосту старосьце старостам
Household = Гаспадарка
illuminate = асьветлены (рэлігія Вландыі)
Induction = Прыняцьце (у веру)
inheritance = спадчыннасьць
innovations = інавацыі
inspiration = натхненьне
Instructor = настаўнік
Ira = Айра
knighthood = рыцарства
lady = шляхцянка, пані, спадарыня (калі ветлівы зварот)
landed = зямельны
legal = законны
liege = сюзэрэн
lifestyle perk = перавага лада жыцьця
lord = шляхціч, панове, спадар (калі ветлівы зварот)
lordship = баронства
loyalty = лаяльнасьць 
Manor = Маёнтак
manpower = чалавечая моц
Marshal = Гетман
Méhns = Мэхн
militarism = мілітарызм
offering = ахвяраваньне
pastureland = пашы, Запашваньне
Peerage = Набілітацыя
Peers = Нобіль, Нобілі
Pérkenweyd = Пэркенўэйд
Pérkos = Пэркас
piety = набожнасьць
pool = рэзерв (manpower, чалавечай моцы)
position = пасада
Presence = Наяўнасьць
priory = кляштарства
privileges = прывілеяў
rank  = ранг
realm = гаспадарства
Reason = нагода
religions = рэлігіі
research = дасьледаваньня
Retinue = сьвіта
Rex Sacrarum = Гаспадарус Сьвятум
Rhagaea = Рыджыя
rite = абрад
scholarship = Шкалярства
scriveners = пісьменнымі
Serfs = прыгонны
slaves = рабоў
smithing = кавальства
sovereign = суверэн
spy = шпег
Stability = Стабільнасьць
stash = тайнік
steward = падскарбі (у сойме), загаднік (іншыя выпадкі)
succession = спадкаемства
suzerain = сюзэрэн
task = заданьне
Theology = Тэалогія
titles = тытулы
vassal = васаламі
volunteers = самаахвотнікі
Wisdom = Мудрасьць
Workforce = Працоўная Моц