Agama = Агама
Ardron = Ардрон
Banish Land = Зямлю Выгнання
Cagie = Кажы, Кажыец, Кажыйцы, Кажыйскі
Couch Lance = Наезд дзідай
Custom Troop, Customized Troops = наладжвальныя ваяры, наладжвальных ваяроў
Derian = Дзірыян
Elin = Элін, Эліны, Элінскі
Geliran = Гелірэн
grassland king = Караля Стэпаў
Grode = Гроўд
Icey = Айсі
Lomoca = Ламока, Ламокі, Ламоцкі
Lorin = Лорын
Lotas = Лотас
master (рабоў) = спадар
Melethvon = Мелетвон
Mogrian = Могрыя, Могрыйцы, Могрыйскія
Monnai = Моннай
Navi = Наві
Nekenia = Некенія, Некены, Некенскі
Pet = гадаванец, гадаванцаў
Prouen = Пруэн, Пруэны, Пруэнскі
Rabblam = Рабблам, Раббламы, Раббламскі
Radruweel = Радрувіл
Ryenus = Раінэс
Sally = Салі
Sika = Сіка, Край Сіка, Сіканцы
Slavers = Занявольнікі
Spear Brace = Дзіду ў Зямлю
stronghold = крэпасць
The Land Of Sika = Зямля Сіка
Vilken = Вілкен
Vultur = Вальтура
Wulltes = Вульціс, Вульцісы, Вульціскі
Xiang = Сян
Yan = Янь, Яньцы, Яньскі
Yarian = Ярын, Ярыны, Ярынскі