Altdorf = Альтдорф
Altern Forest = Лес Альтэрн
Aqshy = Экшы
Aquitaine = Аквітань, Аквітаньскі
Assembly of Віссэнлянд = Сойме Віссэнлянда
Aver = Авер
Averland = Аверлянд, аверляндзкі, аверлянды
Bastonne = Бастонн, Бастонскі
beastmen = Зьвералюд
Blackfire Pass = Перавал Чорнае Полымя
Blood Dragons = Крывавыя Драконы
Blue Reach = Блакітная Мяжа
bondmen = абавязьнікі *** ад абавязак (вузы не падыходзіць, бо слова вузьнік ужо існуе і мае іншае адценьне)
Bordeleaux = Бордулю, Бордульскі
Braganza = Браганза
Bretonnia = Брэтоньнія, брэтоньскі, брэтоньцы
Bright Wizard = Зыркі Чараўнік
Brionne = Брыённ, Брыёнскі
Broken Wheel = Зламанае Кола
Bylorak = Бюлорак
Carcassonne = Каркассон, Каркассонскі
Chaos Undivided = Хаос Непадзельны
charter (town) = хартыю
contemporary era = навейшай эры
Crossed Keys = Скрыжаваныя Ключы
daur = даурскі
domain = валадарства
Dragon Ogre = Драконі Огр
Drakenhof = Дракенхоф, дракенхофскі
Dwarfen Kingdoms = Гаспадарствы Гномаў
Eschenstir = Эшэншцір
Estalia, Estalian = Істалія, Істалійскі
Fieldwardens = Палявыя Нагляднікі
foul creatures = нячысьцікі
Goblins = Гобліны
Great Forest = Вялікі Лес
Greataxe = Выдатная Сякера
Greatswords = Выдатныя мячы
Halflings = Паўросьлікі
Haunted Hills = Прывідныя Ўзгоркі
Hunger Wood = Галодны Лес
Khornate = Кхорната
Khorne = Кхорн
Lahmian = Ламіан, Ламіанская
Lammer = Ламмер
Light Mages = Сьветлыя Магі
Lord (Empire, Vampire) = Шляхціч
Lustria = Люстрыі
Lyonesse = Ліонэсс
modern era = сучаснай эры 
Montfort = Мунфор, Мунфорскі
Moot = Муут, мууцкі
Mootlands = Муутлянд, муутляндзкі, муутлянды, жыхары муута
Morfens = Морфен
Morr = Морр 
Mousillon = Музільён, Музільёнскі
Nagash = Нагаш
Nattern Forest = Лес Наттарн
Neutral = Нейтрал
Nuln = Нульн, нульнскі
Nurgle = Нургл
Nurgle’s Rot = Гніеньня Нургла
Nurglite = Нургліт
Old Dwarf Road = Стары Шлях Гномаў
Parravon = Парравун, Парравунскі
Pfunzig = Фунцыг
pilgrims = пілігрымаў
priests = сьвятар
prophetess = Прарочыца
Quenelles = Кунэль, Кунэльскі
Raven Knights = Крумкачыя Рыцары
Reik = Райк
Reikland = Райклянд, Райкляндзкі
Reiksguard = Райксгард, райксгардзкі
Reman = Рыман, рыманскі, рыманцы
Rhya = Рая
Riverwardens = Рачныя Нагляднікі
Roadwardens = Дарожныя Нагляднікі
Shallya = Шальля
Sharanorak = Шаранорак
Siegfriedof = Зігфрыдоф
Sigmar = Зігмар 
Slaanesh = Слаанэш
Sorcerer = Вядзьмар
State = Дзяржаўны
Stir = Шцір, шцірскі
Stirland = Шцірлянд
Strigany = Стрыганы
Svarsee = Сварзіі
Sylvania = Сільванія, сільванскі, сільваны
Taal = Тааль
Talabecland = Талабэклянд, Талабэкляндзкі
Tilea, Tilean = Цілея, Цілійскі
Troop = жаўнер
Tzeentch = Тзіінч
Ulric = Ульрык
Ungor = Нярох *** бо маюць ня такія рогі
Vampire Counts = Графы-Вампіры
Verena = Вярэна
Voland = Воланд
Von Carstein = фон Карштайн
Von Kragsburg = фон Краксбург
Wailing Woods = Лес Плачу
Wight King = Вайскавод-Мярцьвяк
Wissenland = Віссэнлянд
Wizard = Чараўнік
Wizard = Чараўнік
World’s edge mountains = Горы Рогу Сьвету
Zaya hills = Узгоркі Зая