Aegon's Conquest = Заваёва Аэгона
Age of Heroes = Эра Герояў
Andals = Андалы, Андальскі
Ashwood = Ясень
Asshai = Асшай
Battle of the Trident = Бітва Трызуба
Bay of Pentos = Затокі Пэнтос
Bearded Priest = Барадаты Святар
Blackwater Bay = Чорнаводная Затока Чорная Вада
Blood Rider = Крывавы Наезьнік
Bole = Боўл
Braavos = Браавос, Браавоскі, Браавосы
Casterly Rock = Скала Кастэрлі
City of Sorcerers = Горад Ведзьмароў
Condon = Кондан
crannogmen = людзі краннога
Crownlands = Каронных Земляў
Crows = Крумкачы
Daenerys Stormborn = Даэнэрыс Шторманароджаная
Danaerys = Данаэрыс
Defender of the Vale = Абаронца Даліны
Dorne = Дорн, Дарнійскі
Dornish = Дорн, Дарнійскі, Дарнійцы
Dothraki = Дотракія, Дотракійскі, Дотракійцы
Downed God = Патанулы Бог
Dragonstone = Цмачыны Камень
Driftmark = Дрэйфмарк
Drowned God = Патанулы Бог
Duskendale = Змрочная Даліна
enlisted = найміт найманьня найміцтва
Essos = Усходас
Faceless Men = Безаблічны
First Men = Першыя Людзі
Flea Bottom = Блышынага Дна
Fleabottom = Блышынае Дно
Free Cities = Вольных Гарадах
Free Folk = Вольны Народ
Free Houses = Вольныя Дамы
Ghiscari = Гіскар, Гіскарскі, Гіскары
Ghiscari wars = Гіскарскія Войны
Gods Eye = Вока Бога
Gold Cloak = Залаты Плашч
Golden Empire = Залатая Імперыя
Great Grass Sea = Вялікае Травяное Мора
Greenblood = Зялёная Крывя
Grue = Гру
haunted forest = прывідны лес
Hollow Hill = Парожніх Узгоркаў
House of Black and White = Дом Чорнага і Белага
House Targaryen = Дом Таргарыен
imp = Нячысьцік (Tyrion Lannister)
Iron Bank = Жалезны Банк
Iron Islands = Жалезныя Выспы
Iron Throne = Жалезны Трон
Ironborn = Жалезнанароджаны
Joffrey = Джоффры
Khal = Хал 
Khalasar = Халасар
King in the North = Кароль Поўначы
King of Salt and Rock = Кароль Солі і Каменьня
King's Justice = Каралеўскі Судзьдзя
King's Landing = Каралеўская Прыстань
Kingsguard = Каралеўская Гвардыя
Knight of the Gate = Рыцар Брамы
Known World = Вядомы Сьвет
Lengii = Лэнгійскі
Lorath = Лорат, Лорацкі, Лораты
Lord Paramount = Вярхоўны Лорд
Lord Paramout = Першасны Шляхціч
Lys = Лыс, Лыскі, Лысы
Mad King = Шалёнага Караля
Many-faced god = Многатвары Бог
Mareen = Марын
Master of Whisperers = Майстар Шаптуноў
Masters = Майстар
Mother of Dragons = Маці Цмокаў
Mountains of the Moon = Гор Месяца
Myr = Мыр, Мырскі, Мыры
Narrow Sea = Вузкае мора
Night King = Начны Кароль
Nightlands = Начные Землі
Nights Watch = Начны Дазор
North = Поўнач, Паўночны, Паўночнікі
Norvos, Norvoshi = Норвас, Норваскі, Норвасы
Nymeria = Німерыя
Old Empire of Ghis = Старая Імперыя Гіс
Pentos = Пэнтос, Пэнтоскі, Пэнтасы
Pyke = Пік
Qarth = Кварт
Qohor = Кохар, Кохарскі, Кохары
R'hllor = Р'глор
Reach = Мяжа (заўжды праз я, каб адзьдзяліць)
Reachman = Людзі Мяжы (заўжды праз я, каб адзьдзяліць)
Red Wedding = Чырвонае Вясельле
Rhoynar = Ройнар, Ройнарскі, Ройнары
Rhoyne = Ройн
Rhyonar = Рёнар, Рёнарскі, Рёнары
Riverlands = Рачныя Землі
Riverman = Рачныя Людзі
rugged island = Зрэзаныя Выспы
Sarnor = Сарнор, Сарнорскі, Сарноры
Sea of Myrth = Мора Мірт
Septa Unella = Сэпта Унэлла
Septon = Сэптон
Seven Kingdoms = Сем Каралеўстваў, Сямі Каралеўстваў
Seven-Pointed Star = Сяміканцовай Зоркі
Shivering Sea = Дрыгучае Мора
Skagos = Скагос, Скагоскі
Slaver's Bay = Затока Занявольнікаў
Stannis = Станьніс
Stepstones = Ступеністыя Камяні
Stormlands = Штармавыя Землі
Storms End = Штармавы Канец
Strickland = Стрыклянд
Summer Isles = Летнія Выспы
Summer Sea = Летняе Мора
Tall Men = Высокія Людзі
Targaryen = Таргарыены
Thenn = Тэн, Тэнскі
Tyrosh = Тайрош, Тайроскі, Тайрошы
Tywin = Тайўін
Unsullied = Бездакорны
Vale of Arryn = Даліна Аррын
Valeman = Людзі Даліны
Valyrian = Валірыя, Валірыйскі, Валірыйцы
Viserys = Візэрыс, Візэрыскі
Volantis, Volantene = Валанціс, Валанцкі, Валанцы
War of the Five Kings = Вайна Пяці Каралёў
Warden of the West = Нагляднік Захаду
westerlands = Заходнія Землі, Заходніх Зямель
Westeros = Захадас
Westerosi = Захадасы
White Walker = Белыя Блукачы
wight = Мярцьвяк, Мерцьвякі
wildlings = адзічэлымі
Winter is coming = Зіма надыходзе
Womb of the World = Улоньне Сьвету
Yi Ti = І Ці
Young Griff = Малады Грыф